************************************************************
*        *                                           *     *
*        *                                           *     *
*        *                                           *     *
*   **   *     *********************************     *     *
*   *                                                *     *
*   *                                                *     *
*   *                                                      *
*          *****                            *****          *
*                                                          *
*                                                          *
*          *****                            *****          *
*   *                                                      *
*   *                                                *     *
*   *                                                *     *
*   **   *     *********************************     *     *
*        *                                           *     *
*        *                                           *     *
*        *                                           *     *
************************************************************
