************************************************************
*           *                                  *           *
*                                              *           *
*           *                                              *
*   ******************                         *           *
*                    *                         *           *
*                    *                         *           *
* *******            ********                  *           *
*       *                   *                  *           *
*       *                   *                  *           *
*       *****      **       *                              *
*           *      **       *                  *           *
*           *      **       *                  *           *
*           *      **       ***********  ****************  *
*                  **                            *         *
*                                                *         *
*                  **                                      *
*                  **                            *         *
*                  **                            *         *
************************************************************